#####################  
#   #                  
# # # # # ### ### #####
# # # # # # #   #   # #
# ### ##### # ### ### #
#   # #   #   #   #   #
### ### ### ### ### ###
#             #   # # #
##### ### ######### # #
# #   #   #   # # # # #
# # ### # # ### # # # #
# # #   #   # #       #
# # # # ##### # # # ###
#   # #         # # # #
####### ######### ### #
# #           #       #
# ##### ##### ##### # #
#   #   #     #   # # #
# ##### ### ### ### ###
#       # #   #     # #
# # ### # ##### # # # #
  # #     #     # #   #
  #####################
