#########  
#     #    
### ### ###
#         #
# ### #####
# # #     #
### # ### #
#   # #   #
### # ### #
        # #
  #########
