#####################  
# # #     #     #      
# # # ####### # ##### #
# #     # #   #       #
# ### # # ### # #######
#     # #     #   #   #
####### ### ####### ###
#     #           #   #
# ##### ##### ##### ###
#   #   #       #     #
# # ### ### ######### #
# # #   #         # # #
### ##### ### # ### # #
#   #   # #   #   #   #
### # ##### ##### # # #
#     #   #     # # # #
# # ##### # # ### ### #
# # #       #   #   # #
### ######### ####### #
# # # #         # # # #
# # # # # ### ### # # #
        #   #         #
  #####################
