#########  
#          
# # # ### #
# # # #   #
### # #####
#   #     #
####### # #
# #   # # #
# # ### # #
        # #
  #########
