  #####################
        #     # #     #
### # ### ##### # ### #
#   # # #     #   #   #
### ### ##### # #######
# # # # #   #   #     #
# # # # ### ### ##### #
#             #   #   #
# ##### # ### # # ### #
#   # # # #     # #   #
##### # # # ### ##### #
# #   # # #   #     # #
# # # # # ### # # ### #
# # #   #   # # #     #
# ####### ######### # #
#     # #     #   # # #
### # # ### ### # ### #
#   # #       # #     #
### ### ### ####### # #
#       #         # # #
# ##### ### ##### ### #
#   #     #     #   #  
#####################   