  #########
  # #   # #
# # ### # #
#     #   #
# ##### # #
#       # #
# ### # ###
# # # #   #
### # # # #
#     # #  
#########   